############
#*.........#
##########.#
#......#...#
#.#.#.##.#.#
#.#.####.###
#.###..#...#
#...#.####.#
#o#........#
############
