############
#....#.....#
#.##..#.#.##
#...#.###.##
#.#..o.....#
#.#.#.####.#
#.#.#....#.#
#.##########
#.........*#
############
