############
#.#...#....#
#...#...#..#
########..##
#o.......#.#
#.########.#
#..........#
#####.######
#..##*##..##
############
