############
#.#........#
#.#.######.#
#.#....#...#
#.###.##.#.#
#...####.#.#
#.#.#..#.#.#
#.#.#.##.#.#
#o#......#.#
############
