############
#o.........#
#..........#
#..........#
#..........#
#..........#
#..........#
#..........#
#.........*#
############
